11111111111111111111111111111111111111111111111111
10001100000000000000000000000000000000000000000001
10001100000000000000000000000000000000000000000001
10001100000111100000000000000000000000000000000001
10001100000111100000111111111111111111111111111111
10001100000000000000000000000000000000001111000001
10001100000000000000000000000000000000001111001001
10001100000011111000000000111111111111111111001001
10001100000011111000000000111111111111111111001001
10001100000000000000000000111111111111111111001001
10000000000000000000000000000000000000001111001001
10000000000000000011111111101100000000001111000001
10000000011100000011111111101100000000001111001001
10000000011100000011100000001100001100001111001001
10011111111100000011101111111100001100001111001001
10000000011100000011101111111100001100001111001001
10000000011100000011101111111100001100001111001001
10001100011100000011101111111100001100001111001001
10001100000000000011111111111100001100000000000001
10001100000000000000000000000000001100000000000001
10001111111111100000000000000000001100000000000001
10001111111111100000000000000011111111111100000001
10001100000000000000000000000011111111111100000001
10001100000000000111111000000011111111111100000001
10001100001111111111111000000011111111111100000001
10001100000000000111111000000000000000000000000001
10001100000000000111111000000000000000000000000001
11111111111111111111111111111111111111111111111001
11111111111111111111111111111111111111111111111001
11111111111111111111111111111111111111111111111001
11111111111111111111111111111111111111111111111001
11111000000000000000000000000000000000000000000001
11111000000000000000000000000000000000000000000001
11111000111111111111111111111111111111111111111001
11111000111111111110000000000000000000001111111001
11111000111111111111111111111111111100001111111001
11111000111111111111111111111111111100001111111001
11111000000000000000000000000000000000000000000001
11111000000000000000000000000000000000000000000001
11111001111111111100111000011111111111111111111111
11111001100000000000111000011111111111111111111111
11111001100111100000111000000000001110000000000001
11111001100111100000111000000000001110000000000001
11111001100111100000111000000000001111110111110001
11111001100111100000111000000000001111110111110001
11111000000111100000111000000000001110000000000001
11111111111111100000111001111100001110000111110001
10000000000000000000000000000000000000000111110001
10000000000000000000000000000000000000000111110001
11111111111111111111111111111111111111111111111111