11111111111111111111111111111111111111111111111111
10111100000000000000000000000000000000000000000001
10111100011111111111111111111111111111111111111111
10111100011111111111111111111111111111111111111111
10111100011100000000000000000000000000000000000001
10111100011100000000000000000000000000000000000001
10111100011111111111111111111111111111111111110001
10111100011100000000000000000000000000000000000001
10111100011100001111111111111111111111111111111111
10111100000000001111111111111111111111111111111111
10000000000000000000000000000000000000000000000001
10001100110011001111111111111111111111111111110001
10001100110011001111111111111111111111111111110001
10001100110011000000000000000000000000000000110001
10001100110011001111111111111111111111111100110001
10001100000000000000000000000000000000001100110001
10001100000000000000000000000000000000001100110001
10001100110011111111111111111111111111001100110001
10001100110011111111111111111111111111001100110001
10001100110011100000000000000000000011001100110001
10001100110011100011111111111100110011001100110001
10001100110011100011100000011100110011001100110001
10001100110011100011100000011100110011001100110001
10001100110011100011100011011100110011001100110001
10001100110011100011100011011100110011001100110001
10001100110011100011100011011100110011001100110001
10001100110011100011100011011100110011001100110001
10001100110011100011100011011100110011001100110001
10001100110011100011111111011100110011001100110001
10001100110011100011111111011100110011001100110001
10001100110011100000000000011100110011001100110001
10001100110011100000000000011100110011001100110001
10001100110011111111111111111100110011001100110001
10001100110011100000000000000000110011001100110001
10001100110011111111111111111111110011001100110001
10001100000000000000000000000000000011001111110001
10001111111111111111111111111111111111111111110001
10000000000000000000000000000000000000000000000001
10000000000000000000000000000000000000000000000001
10001111111111111111111111111111111111111111110001
10000000000000000000000000000000000000000001110001
10001101111111111111111111111111111011111111110001
10001100000000000000000000000000011011000000110001
10001101111111111111111111111111011011000010110001
10001101100000000000000000000011011011111110110001
10001101101111111111111111111111011000000000110001
10001111100000000000000000000000011011111111110001
10000000000000000000000000000000000000000000000001
10000001111111111111111111111111111000000000000001
11111111111111111111111111111111111111111111111111