11111111111111111111111111111111111111111111111111
10000000000000000000000000000000000000111100000001
10000000000000000000000000000000000000111100010001
10001111111111111100000000000000000000111100010001
10001000000000011100000000000000000000111100010001
10001000011000011100000001111111100000111100010001
10001000011000011100000001111111100000111100010001
10001000011000011100000001111111100000111100010001
11111000011000011100000001111111100000000000010001
10000000011000011100000000000000000000000000000001
10000000011000011100000000000000011111111111100001
11111111111000011100000000000000000000000000000001
11111111111000011111111111111111111111100000000001
10000000000000011111111111111111111111100000110001
10000000000000000000111100000000000000000000110001
10000000000000000000111100000000000000000000110001
10000011111111111111111100000111111111110000110001
10000011111111111111111100000110000000110000110001
10000000000011110000111100000110010000110000110001
10000000000011110000111100000110011111110000110001
10000110000011110000111100000110000000000000110001
10000110000000000000111100000111111111110000110001
10000110000000000000111100000111111111110000110001
10000110000000000000111100000000000000000000110001
10000110000000000000000000000000000000000000000001
10000110000000000000000000000000000000000000000001
10000111111111111111111111111111111111111110000001
10000111111111111111111111111111111111111110000001
10000001110000000000000000000000000000000000000001
10010001110000000000000000000000000000000000000001
10010001110001111111111111111111111111111111111001
10010001110001111111111111111111111111111111111001
10010001110001100000000000000000000000000001111001
10010001110001100000000000000000000000000000000001
10010001110001100011111111111111111111110001111001
10010001110001100011000000000000000001110001111001
10010001110001100011000000000011110001110001111001
10010000000001100011000000000011110001111111111001
10000000000001100011111111111111110001110011111001
10010001110001100000111111111111110001110001111001
10010001110001100000000000000000000001110001111001
10010001110001111111111111111111111111110001111001
10010001110001111111111111111111111111110001111001
10010001110001111111111111111111111111110001111001
10010001110000000000000000000000000000000001111001
10010000000000000000000000000000000000000001111001
10011111111111111111111111111111111111111111111001
10000000000000000000000000000000000000000000000001
10000000000000000000000000000000000000000000000001
11111111111111111111111111111111111111111111111111