11111111111111111111111111111111111111111111111111
10000111000000000000000001111000001111100000000001
10000111000001111000000001111000001111100000000001
10000111000001111000000001111000001111100000000001
10000111111111111000000001111000001111100011110001
10000111111111111000000001111000001111100011110001
10000111000000000000000001111000001111100011110001
10000111000000000000000001111000001111100011110001
10000111000000000000000001111000001111100011110001
10000000000000001110000000000000001111100011110001
10000000000000001110000000000000001111100011110001
10000000000000001110000111111000001111100011110001
11111111111111111110000111111000001111100011110001
11111111111111111110000111111000001111100011110001
10000000000000000000000111111000001111100011110001
10001111111111111110000111111000001111100011110001
10000000000001111110000111111000001111100011110001
11111111111101111110000111111000001111100011110001
11100000111101111110000000000000001111100011110001
11100000000001111110000000000000001111100011110001
11111111111111111110000000000000000000000011110001
10000000000000000000000000000000000000000011110001
10000000000000000000000000000000000000000011110001
10001100000011111111111111111111111000000011110001
10001100000000000000000011110000000000000011110001
10001111111111100000000011110000000000000011110001
10001111111111100000000011110000000000000000000001
10001100000000000000000011110000000000000111100001
10001100000000000000000011110000000000000111100001
10001100000111110011000011111111111111111111100001
10000000000111000011000011111111111111111111100001
10000000000111000011000011111111111111111111100001
10001110000111000011000011110000000000000000000001
10001110000111111111000011110000000000000000000001
10001110000000000000000000000000000011111111111111
10001110000000000000000000000000000000000000100001
10001111111111111111111110011100111111111111101001
10001111111111111111111110011100110000000111101001
10001110000000000000000000011100110001100111101001
10001110000000000000000000011100110001100111101001
10001110000000000000000000011100110001100111101001
10000000000000111111111110011100110001100111101001
10000000000000111111111110011100110001100111101001
10000000000000111111111110011100111111100111101001
10000111111111111000000000011100000000000000001001
10000111111111111000000000011111111111111111111001
10000000000000111000000000000000000000000000000001
10000000000000111000000000000000000000000000000001
10000000000000111000000000000000000000000000000001
11111111111111111111111111111111111111111111111111