11111111111111111111111111111111111111111111111111
10000000111110000000000000000000000000000000000001
10000000155510000000000000000000000000000000000001
10000111111111110000000000000000000000000000000001
10000111111111110000000000000000000000000000000001
10000110005000110000000000000000000000000000000001
10000110000000110000000000000000000000000000000001
10000110000000110000000000000000000000000000000001
10000110000000110000000000000000000000000000000001
10000111100011110000000000000000000000000000000001
10000111100011110000000000000000000000000000000001
10000000000000000000000000000000000000000000000001
10000000000000000000000111110000000000000000000001
10000000000000000000000133310000000000000000000001
10000000000000000011111111111111100000000000000001
10000000000000000011111111111111100000000000000001
10000000000000000011000008000001100000000000000001
10000000000000000011000000000001100000000000000001
10000000000000000011000000000001100000000000000001
10000000000000000011000000000001100000000000000001
10000000000000000011000000000001100000000000000001
10000000000000000011000000000001100000000000000001
10000000000000000011000000000001100000000000000001
10000000000000000011000000000001100000000000000001
10000000000000000011000000000001100000000000000001
10000000000000000011111100011111100000000000000001
10000000000000000000000000000000000000000000000001
10000000000000000000000000000000000000000000000001
10000000000000000000000000000000000000000000000001
10000000000000000000000000000000000000000000000001
10000000000000000000000000000000000000000000000001
10000000000000000000000000000000000000000000000001
10000000000000000000000000000000000000000000000001
10000000000011111000000000000000000000000000000001
10000000000012221000000000000000000000000000000001
10000011111111111111111000000000000001111100000001
10000011111111111111111000000000000001444100000001
10000011000000700000011000000000001111111111100001
10000011000000000000011000000000001111111111100001
10000011000000000000011000000000001100090001100001
10000011000000000000011000000000001100000001100001
10000011000000000000011000000000001100000001100001
10000011000000000000011000000000001100000001100001
10000011111110001111111000000000001111000111100001
10000011111110001111111000000000001111000111100001
10000000000000000000000000000000000000000000000001
10000000000000000000000000000000000000000000000001
10000000000000000000000000000000000000000000000001
10000000000000000000000000000000000000000000000001
11111111111111111111111166661111111111111111111111