11111111111111111111111111111111111111111111111111
10000000000000000000000000000000000000000000001111
10000000000000000000000000000000000000000000001111
10000000000000000000000000000000000000000000001111
11111111111111111111111111111100000000000000001111
11111111111111111111111111111100000000000000001111
10000000000000000000000000000000000000111100001111
10000000000000000000000000000000000000111100001111
10000000000000000000000000000000000000111100001111
11111111111000001111111000001111110000111100001111
11111111111000001111111000001111110000111100001111
10000000011000001111111000000000000000111100001111
10000000011000001111111000000000000000111100001111
10001100011000001111111000000001110000111100001111
10001100011000001111111000000001110000111100001111
10001100011000001111111000000001110000111100001111
10001100011000001111111000000001110000111100001111
10001100011111111111111000000001110000111100001111
10001100011111111111111000000001110000111100001111
10001100011111111111111000000001110000000000000001
10001100000000000000000000000001110000000000000001
10001100000000000000000000000001110000000000000001
11111100000011111111111111111111111111111111111111
11111100000011111111111111111111111111111111111111
10000000000011111111111111111111111111111111111111
10000000000000000000000000000000000000000000000001
11111111111111111000011000000000000000000000000001
11111111111111111000011000000000000000000000000001
10000000000000000000011000000000000000000000000001
10000000000000000000011111111111111111111111000001
10000000000000000000011111111111111111111111000001
10000111111111111111111000000000000000000000000001
10000111111111111111111000000000000000000000000001
10000111111111111111111000000111110000111111110001
10000000000000000000000000000111110000111100000001
10000000000000000000000000000111110000111100000001
10000000000000000000000000000111110000111100000001
10001110001111111111111111111111111111111111111111
10001110000000000000000000000000000000000000000001
10001110000000000000000000000000000000000000000001
10001110000011111111111111111111111111111111111111
10001110000011111111111111111111111111111111111111
10001110000011111111111111111111111111111111111111
10001110000000000000000000000000000000000000000001
10001110000000000000000000000000000000000000000001
10001110000000000011111000000111111111111111111111
10001110000000000011111000000111111111111111111111
10001110000000000011111000000000000000000000000001
10001110000000000011111000000000000000000000000001
11111111111111111111111111111111111111111111111111