11111111111111111111111111111111111111111111111111
10000000000000000000000000000000000000000000000001
10001110000000000000000000000000000000000000000001
10001110000000111111111111111111111111111111111111
10001110000000000000000000000000000000000000000001
10001110000000000000000000000000000000000000000001
10001111111111111111111111111111111111111111100001
10001111111111111111111111111111111111111111100001
10000000000111000000000000000000000000000000000001
10000000000111000000000000000000000000000000000001
10000111111111000001111111111111111111111110000001
10000111111111000001111111111111111111111110000001
10000000000111000000000000000000000000000000000001
10000000000111000000000000000000000000000000000001
10001110000111111111111111111111111111111110000001
10001110000111111111111111111111111111111110000001
10001110000000001110000000000000000000000000000001
10001110000000001110000000000000000000000000000001
10001110000000001110001111111111111111111111110001
10001110000000001110001111111111111111111111110001
10001111111111111110001110000000000000000001110001
10001111111111111110001110000000000000000001110001
10000000000000000000001110001111111111110001110001
10000000000000000000001110001111111111110001110001
10001111100001111100001110001100000000110001110001
10011111111111111110001110000000000000110001110001
10000111111111111000001110001100011000110001110001
10000000111111100000001110001100011000110001110001
10000000001110000000001110001100011000110001110001
10000000000100000000001110001100011000110001110001
10000000000100000000001110001100011000110001110001
10000000000100000000001110001100011000110001110001
10000000000100000000001110001100011000000001110001
10001111111111111111111110001100011000000001110001
10001111111111111111111110001100011000110001110001
10000000000000000000001110001100011111110001110001
10000000000000000000001110001100011111110001110001
10000000000000000000000000000000000000000001110001
10000000000000000000000000000000000000000001110001
10000000000011111111111111111111111111111111110001
10001111100011111111111111111111111111111111110001
10001111100000000000000000000000000000000000000001
10001111100000000000000000111111111111111111111001
10001111100011111111110000111000000000000000011001
10001111100011111111110000111011111111111111011001
10001111100000000000000000111011100000000011011001
10000000000000000000000000111000000000000011011001
11111111111111111111100000111111111111111111011001
11111111111111111111100000000000000000000000000001
11111111111111111111111111111111111111111111111111